You close the door behind you, and put the key in your pocket. Here you are. Franks house. You used to be friends. You think perhaps you still are, but maybe sneaking into his house will be the end of that. But you haven't heard from him, even after writing every week for the past month, so now you're worried, too. You brought your camera, in case you need to remember the past. 
 Use the "photograph" action, or "p" to take pictures of objects in the house. You can then open the camera to view the memories that object triggers. 
 You can leave at any time by walking back out the door. 

248 Assignment 2 Part 2 - Photography Game
An Interactive Fiction by Bjarke
Release 1 / Serial number 210517 / Inform 7 build 6M62 (I6/v6.33 lib 6/12N) SD

Entrance
The Entrance. The shoerack is the same, albeit a bit more dusty than you remember it. 
Further north is a living room, and up the stairs is a hallway above.

A shoerack. Good as new, and empty.

A jacket hangs on the coathanger. It's his, you'd recognize it anywhere.

>take camera
It feels heavier than you imagine. As if there are more things inside it than it has room for.

Taken.

>i
You are carrying:
  a camera

* * *

>take camera
It feels heavier than you imagine. As if there are more things inside it than it has room for.

Taken.

>look at books
You see nothing special about Books.

>photograph books
*click*
You get a great shot of the books.

* * *

>take camera
It feels heavier than you imagine. As if there are more things inside it than it has room for.

Taken.

>photograph book
*click*
You get a great shot of the books.

The book screams.

>i
You are carrying:
  a camera

The book screams.

* * *

>take camera
It feels heavier than you imagine. As if there are more things inside it than it has room for.

Taken.

>touch camera
Inside the Camera
Your vision is overtaken by dust and film. It smells like phosphor. Your body is weightless.

>touch camera
Inside the Camera
Your vision is overtaken by dust and film. It smells like phosphor. Your body is weightless.

>i
You are carrying:
  a camera

* * *

>photograph shelves
You need a camera to photograph anything.

*click*

>take camera
It feels heavier than you imagine. As if there are more things inside it than it has room for.

Taken.

>photograph shelves
*click*

>photograph books
*click*
You get a great shot of the books.

*click*

* * *

>look picture
You see nothing special about the picture.

>examine picture
You see nothing special about the picture.

* * *

>look at picture
It is a picture of your friend, Frank. You don't remember taking this.

>examine picture
It is a picture of your friend, Frank. You don't remember taking this.

* * *

>e
You can't go that way.

>n
Living Room
The most prominent element in the living room his old dining table. Behind it are stacks of shelves. 
The east opens up to the kitchen. Back south is the entrance.

You can see a dining table (on which is a picture) and shelves (in which are an unmailed letter and a project report) here.

>e
Kitchen
A kitchen, just big enough for another person to squeeze by when one is cooking.

>w
Living Room
The most prominent element in the living room was always the old dining table

You used to remember the story of how he got it. It was something to do with a misunderstanding. And a mistyped phone number.

>n
You can't go that way.

>s
Entrance
The Entrance. The shoerack is the same, albeit a bit more dusty than you remember it.

An old, dusty camera lies on the ground.

>up
Hallway
a short hallway, just big enough for two doors.

>e
bedroom
You never went in here much.

>w
Hallway
a short hallway, just big enough for two doors.

>w
Guest Room
The bed was always mildly uncomfortable. But you could never get yourself to tell him.

A picture is stuck in the corner.

You can also see a book and Shelves here.

>e
Hallway
a short hallway, just big enough for two doors.

>down
Entrance
The Entrance. The shoerack is the same, albeit a bit more dusty than you remember it.

An old, dusty camera lies on the ground.

* * *

>n
Living Room
The most prominent element in the living room his old dining table. Behind it are stacks of shelves. 
The east opens up to the kitchen. Back south is the entrance.

You can see a dining table (on which is a picture) and shelves (in which are an unmailed letter and a project report) here.

>look at shelves
Stacks of books. What looks like a project report. Opened letters. And one unmailed letter.

In shelves are an unmailed letter and a project report.

>look at unmailed letter
You open the unmailed letter. It's... empty. But addressed to you. The date? 3 years ago. You sigh. Guess he tried.

>photograph unmailed letter
*click*
the unmailed letter is photographed. The camera whirs.

>photograph shelves
*click*
shelves is photographed. The camera whirs.

>photograph project report
*click*
the project report is photographed. The camera whirs.

* * *

>n
Living Room
The most prominent element in the living room his old dining table. Behind it are stacks of shelves. 
The east opens up to the kitchen. Back south is the entrance.

You can see a dining table (on which is a picture) and shelves (in which are an unmailed letter and a project report) here.

>p project report
*click*
the project report is photographed. The camera whirs.

>s
Entrance
The Entrance. The shoerack is the same, albeit a bit more dusty than you remember it. 
Further north is a living room, and up the stairs is a hallway above.

One pair of shoes on the rack. Good as new.

A jacket hangs on the coathanger. It's his, you'd recognize it anywhere.

>n
Living Room
The most prominent element in the living room his old dining table. Behind it are stacks of shelves. 
The east opens up to the kitchen. Back south is the entrance.

You can see a dining table (on which is a picture) and shelves (in which are an unmailed letter and a project report) here.

>e
Kitchen
A kitchen, just big enough for another person to squeeze by when one is cooking. The kitchen counters are clean. 
Back west is the living room.

On the kitchen counter is a set of knives.

>examine counter
On the kitchen counter is a set of knives.

>examine knives
He got those knives on one of his trips. Malaysia? Cuba? You don't remember. But he liked them.

>photograph knives
*click*
the set of knives is photographed. The camera whirs.

>w
Living Room
The most prominent element in the living room his old dining table. Behind it are stacks of shelves. 
The east opens up to the kitchen. Back south is the entrance.

You can see a dining table (on which is a picture) and shelves (in which are an unmailed letter and a project report) here.

>s
Entrance
The Entrance. The shoerack is the same, albeit a bit more dusty than you remember it. 
Further north is a living room, and up the stairs is a hallway above.

One pair of shoes on the rack. Good as new.

A jacket hangs on the coathanger. It's his, you'd recognize it anywhere.

>up
Hallway
A short hallway, just big enough for two doors. One east, one west.

>east
Bedroom
His bedroom. It's very sparse. 
Back west is the hallway.

A book is on the nightstand.

An unplayed guitar is in the corner.

You can also see a diary (closed) here.

>examine book
some sci fi book you haven't heard of. But it's very much a thing he'd read.

>x guitar
Unplayed is harsh, perhaps. He played it once or twice. Always said he'd pick it up again. You don't remember seeing him ever do.

>x diary
His diary? Did he keep a diary? In any case, it's locked, so there's no way to know without a key.

>w
Hallway
A short hallway, just big enough for two doors. One east, one west.

>w
Guest Room
It's the same guest bed he always had. It was always mildly uncomfortable. But you could never get yourself to tell him. 
Back east is the hallway.

A potted plant is on the windowsill. It's... pretty dead.

>x potted plant
Upon closer inspection, it is still dead.

>take key
(rummaging your hands through the potted plant, what a thing to do) you find the key in the mouldy earth.

Taken.

>e
Hallway
A short hallway, just big enough for two doors. One east, one west.

I beg your pardon?

>e
Bedroom
His bedroom. It's very sparse. 
Back west is the hallway.

A book is on the nightstand.

An unplayed guitar is in the corner.

You can also see a diary (closed) here.

>unlock diary
What do you want to unlock the diary with?

>brass key
You unlock the diary.

>ready diry
That's not a verb I recognise.

>read diary
His diary? Did he keep a diary? In any case, it's locked, so there's no way to know without a key.

>rules
Rules tracing now switched on. Type "rules off" to switch it off again, or "rules all" to include even rules which do not apply.

>read diary
[Rule "declare everything initially unmentioned rule" applies.]
[Rule "announce items from multiple object lists rule" applies.]
[Rule "set pronouns from items from multiple object lists rule" applies.]
[Rule "before stage rule" applies.]
[Rule "can't act in the dark rule" applies.]
[Rule "instead stage rule" applies.]
[Rule "investigate player's awareness before action rule" applies.]
[Rule "player aware of his own actions rule" applies.]
[Rule "check stage rule" applies.]
[Rule "carry out stage rule" applies.]
[Rule "standard examining rule" applies.]
His diary? Did he keep a diary? In any case, it's locked, so there's no way to know without a key.

[Rule "examine directions rule" applies.]
[Rule "examine containers rule" applies.]
[Rule "examine supporters rule" applies.]
[Rule "examine devices rule" applies.]
[Rule "examine undescribed things rule" applies.]
[Rule "after stage rule" applies.]
[Rule "investigate player's awareness after action rule" applies.]
[Rule "report stage rule" applies.]
[Rule "report other people examining rule" applies.]
[Rule "last specific action-processing rule" applies.]
[Rule "A first turn sequence rule" applies.]
[Rule "every turn stage rule" applies.]
[Rule "A last turn sequence rule" applies.]
[Rule "notify score changes rule" applies.]

>actions
[Rule "declare everything initially unmentioned rule" applies.]
Actions listing on.

* * *

>touch camera
Inside the Camera
Your vision is overtaken by dust and film. It smells like phosphor. Your body is weightless.

An empty picture floats in the space.

>touch camera
Entrance
The Entrance. The shoerack is the same, albeit a bit more dusty than you remember it.

One pair of shoes. Good as new.

A jacket hangs on the coathanger. It's his, you'd recognize it anywhere.

>touch camera
Inside the Camera
Your vision is overtaken by dust and film. It smells like phosphor. Your body is weightless.

>touch camera
Entrance
The Entrance. The shoerack is the same, albeit a bit more dusty than you remember it.

* * *

>touch camera
Entrance
The Entrance. The shoerack is the same, albeit a bit more dusty than you remember it.

One pair of shoes. Good as new.

A jacket hangs on the coathanger. It's his, you'd recognize it anywhere.

>photograph shoerack
*click*
the shoerack is photographed. The camera whirs.

the camera smells like shoeshine

>touch camera
Inside the Camera
Your vision is overtaken by dust and film. It smells like phosphor. Your body is weightless.

An empty picture floats in the space.

You can also see memory of a shoerack here.

>examine memory
"Oh, you still got those?" His voice is hollow, but warm. "Yeah," I shrug. I had those old boots for another two years. He puts his shoes on the rack and walks into the living room.

* * *

>touch camera
Inside the Camera
Your vision is overtaken by dust and film. It smells like phosphor. Your body is weightless.

An empty picture floats in the space.

>photograph room
You can't see any such thing.

* * *

>touch camera
Inside the Camera
Your vision is overtaken by dust and film. It smells like phosphor. Your body is weightless.

An empty picture floats in the space.

>photograph picture
you have no hands with which to use an object you are inside.

>touch camera
Entrance
The Entrance. The shoerack is the same, albeit a bit more dusty than you remember it.

* * *

>move to inside the camera
You can't see any such thing.

>touch the camera
Inside the Camera
Your vision is overtaken by dust and film. It smells like phosphor. There is no body.

* * *

>touch the camera
Inside the Camera
Your vision is overtaken by dust and film. It smells like phosphor. Your body is weightless.

>touch the camera
You can't see any such thing.

* * *

>drop camera
You're not letting go. It feels almost sewn onto your fingers.

>i
You are carrying:
  a camera

>touch camera
Inside the Camera
Your vision is overtaken by dust and film. It smells like phosphor. Your body is weightless.

* * *

>photograph shoerack
*click*
the shoerack is photographed. The camera whirs.

>touch camera
Inside the Camera
Your vision is overtaken by dust and film. It smells like phosphor. Your body is weightless. As all good stories, this one has a beginning, a middle, and an end.

An empty picture floats in the space.

"You two, you're together", the teacher said. And we were, apparently. I had never met him before, but there we were, suddenly, forced to work together.

>photograph picture
you have no hands with which to use an object you are inside. Even the sentence refuses to make sense.

*click*

* * *

>touch camera
Inside the Camera
Your vision is overtaken by dust and film. It smells like phosphor. Your body is weightless. As all good stories, this one has a beginning, a middle, and an end.

An empty picture floats in the space.

"You two, you're together", the teacher said. And we were, apparently. I had never met him before, but there we were, suddenly, forced to work together.

>examine memory
"You still got those?" His voice is hollow, but warm. "Yeah," I shrug. I had those old boots for another two years.

* * *

>touch camera
Inside the Camera
Your vision is overtaken by dust and film. It smells like phosphor. Your body is weightless. As all good stories, this one has a beginning, a middle, and an end.

An empty picture floats in the space.

"You two, you're together", the teacher said. And we were, apparently. I had never met him before, but there we were, suddenly, forced to work together.

>take memory
That's fixed in place.

* * *

>touch camera
Inside the Camera
Your vision is overtaken by dust and film. It smells like phosphor. Your body is weightless. As all good stories, this one has a beginning, a middle, and an end.

An empty picture floats in the space.

"You two, you're together", the teacher said. And we were, apparently. I had never met him before, but there we were, suddenly, forced to work together.

>look at picture
You see nothing special about the empty picture.

>huh
That's not a verb I recognise.

>wait
Time passes.

We had our fights, sure. It's hazy, now, to even remember what they were about. I remember throwing a shoe, once.

"You two, you're together", the teacher said. And we were, apparently. I had never met him before, but there we were, suddenly, forced to work together.

>ok
That's not a verb I recognise.

* * *

>look at picture
You see nothing special about the empty picture.

>wait
Time passes.

We had our fights, sure. It's hazy, now, to even remember what they were about. I remember throwing a shoe, once.

"You two, you're together", the teacher said. And we were, apparently. I had never met him before, but there we were, suddenly, forced to work together.

>wait
Time passes.

>wait
Time passes.

>wait
Time passes.

"You two, you're together", the teacher said. And we were, apparently. I had never met him before, but there we were, suddenly, forced to work together.

But before we knew it, we graduated. Together.

* * *

>photograph shoerack
*click*
the shoerack is photographed. The camera whirs.

>n
Living Room
The most prominent element in the living room was always the old dining table

You used to remember the story of how he got it. It was something to do with a misunderstanding. And a mistyped phone number.

A picture is stuck in the corner.

You can also see a book and Shelves here.

the camera smells like shoeshine

>touch camera
Inside the Camera
Your vision is overtaken by dust and film. It smells like phosphor. Your body is weightless.

An empty picture floats in the space.

You can also see memory of a shoerack here.

* * *

>n
Living Room
The most prominent element in the living room was always the old dining table

You used to remember the story of how he got it. It was something to do with a misunderstanding. And a mistyped phone number.

A picture is stuck in the corner.

You can also see a book and Shelves here.

the camera smells like shoeshine

>photograph shelves
*click*
Shelves is photographed. The camera whirs.

the camera smells like shoeshine

>touch camera
Inside the Camera
Your vision is overtaken by dust and film. It smells like phosphor. Your body is weightless.

An empty picture floats in the space.

You can also see memory of the university meetup and memory of a shoerack here.

>examine memory of university meetup
We always worked together well in university. Got assigned a random group in an early semester, but sometimes luck strikes true, no?

* * *

>photograph shoerack
*click*
the shoerack is photographed. The camera whirs.

>open camera
Inside the Camera
Your vision is overtaken by dust and film. It smells like phosphor. Your body is weightless. As all good stories, this one has a beginning, a middle, and an end.

An empty picture floats in the space.

 A scene fills the space.  A classroom. A teacher. You're sitting in the back, another 50 students or so, spread around the auditorium. It's new and too clean. The blackboard's barely been written on. 
 "You two, you're together", the teacher said. And we were, apparently. I had never met him before, but there we were, suddenly, forced to work together.

>wait
Time passes.

>wait
Time passes.

The scene shifts. We're in a group room, walls covered in post-it notes. We're staring at our monitors, working out some problem. As we always did. 
We had our fights, sure. It's hazy, now, to even remember what they were about. I remember throwing a shoe, once.

>wait
Time passes.

>wait
Time passes.

But before we knew it, we graduated. Together.

>close camera
Entrance
The Entrance. The shoerack is the same, albeit a bit more dusty than you remember it.

One pair of shoes. Good as new.

A jacket hangs on the coathanger. It's his, you'd recognize it anywhere.

>n
Living Room
The most prominent element in the living room was always the old dining table

You used to remember the story of how he got it. It was something to do with a misunderstanding. And a mistyped phone number.

A picture is stuck in the corner.

You can also see a book, Shelves and a project report here.

>photograph project report
*click*
the project report is photographed. The camera whirs.

We had our fights, sure. It's hazy, now, to even remember what they were about. I remember throwing a shoe, once. 
"You two, you're together", the teacher said. And we were, apparently. I had never met him before, but there we were, suddenly, forced to work together.

>s
Entrance
The Entrance. The shoerack is the same, albeit a bit more dusty than you remember it.

One pair of shoes. Good as new.

A jacket hangs on the coathanger. It's his, you'd recognize it anywhere.

>photograph jacket
*click*
the jacket is photographed. The camera whirs.

>open camera
Inside the Camera
Your vision is overtaken by dust and film. It smells like phosphor. Your body is weightless. As all good stories, this one has a beginning, a middle, and an end.

An empty picture floats in the space.

"You two, you're together", the teacher said. And we were, apparently. I had never met him before, but there we were, suddenly, forced to work together.  I remember seeing his jacket in class earlier in the day, thinking he'd be way too flashy to be your friend. Glad you were wrong. 
But before we knew it, we graduated. Together.  We were damn ragged after staying up all night, fixing commas. But hey, we were alive.

>wait
Time passes.

>wait
Time passes.

We had our fights, sure. It's hazy, now, to even remember what they were about. I remember throwing a shoe, once. 
"You two, you're together", the teacher said. And we were, apparently. I had never met him before, but there we were, suddenly, forced to work together.  I remember seeing his jacket in class earlier in the day, thinking he'd be way too flashy to be your friend. Glad you were wrong.

* * *

>wait
Time passes.

But before we knew it, we graduated. Together.

>wait
Time passes.

>wait
Time passes.

"You two, you're together", the teacher said. And we were, apparently. I had never met him before, but there we were, suddenly, forced to work together.

>wait
Time passes.

>wait
Time passes.

We had our fights, sure. It's hazy, now, to even remember what they were about. I remember throwing a shoe, once.

>wait
Time passes.

* * *

>wait
Time passes.

The scene shifts. We're in a group room, walls covered in post-it notes. We're staring at our monitors, working out some problem. As we always did. 
We had our fights, sure. It's hazy, now, to even remember what they were about. I remember throwing a shoe, once.

I beg your pardon?

I beg your pardon?

>wait
Time passes.

>wait
Time passes.

The scene shifts. Before we knew it, we graduated. Together. The ceremony wasn't the fun part, but we did it.

>wait
Time passes.

>wait
Time passes.

 The scene shifts back.  A classroom. A teacher. You're sitting in the back, another 50 students or so, spread around the auditorium. It's new and too clean. The blackboard's barely been written on. 
 "You two, you're together", the teacher said. And we were, apparently. I had never met him before, but there we were, suddenly, forced to work together.

>p
That's not a verb I recognise.

* * *

>open camera
Inside the Camera
Your vision is overtaken by dust and film. It smells like phosphor. Your body is weightless. As all good stories, this one has a beginning, a middle, and an end.

An empty picture floats in the space.

 A scene fills the space.  A classroom. A teacher. You're sitting in the back, another 50 students or so, spread around the auditorium. It's new and too clean. The blackboard's barely been written on. 
 "You two, you're together", the teacher said. And we were, apparently. I had never met him before, but there we were, suddenly, forced to work together.

>look at teacher
Clara Duvan, her name was. She was a good teacher. Got us through a lot.

>examine teacher
Clara Duvan, her name was. She was a good teacher. Got us through a lot.

We had our fights, sure. It's hazy, now, to even remember what they were about. I remember throwing a shoe, once.

>WHat
That's not a verb I recognise.

>but
That's not a verb I recognise.

* * *

>look at teacher
Clara Duvan, her name was. She was a good teacher. Got us through a lot.

>look at students
There were too many for me to know them all well. I had some friends in there though. So did Frank.

We had our fights, sure. It's hazy, now, to even remember what they were about. I remember throwing a shoe, once.

* * *

>photograph camera
that makes no sense.

>touch camera
Inside the Camera
Your vision is overtaken by dust and film. It smells like phosphor. Your body is weightless.

An empty picture floats in the space.

>photograph picture
you have no hands with which to use an object you are inside. Even the sentence refuses to make sense.

>touch camera
Entrance
The Entrance. The shoerack is the same, albeit a bit more dusty than you remember it.

One pair of shoes. Good as new.

>photograph shoerack
*click*

>e
You can't go that way.

>n
Living Room
The most prominent element in the living room was always the old dining table

You used to remember the story of how he got it. It was something to do with a misunderstanding. And a mistyped phone number.

A picture is stuck in the corner.

You can also see a book and Shelves here.

>s
Entrance
The Entrance. The shoerack is the same, albeit a bit more dusty than you remember it.

One pair of shoes. Good as new.

* * *

>photograph the shoerack
*click*
the shoerack is photographed. The camera whirs.

>touch camera
Inside the Camera
Your vision is overtaken by dust and film. It smells like phosphor. Your body is weightless.

An empty picture floats in the space.

You can also see a memory of a shoerack here.

* * *

>photograph jacket
*click*
the jacket is photographed. The camera whirs.

>touch camera
Inside the Camera
Your vision is overtaken by dust and film. It smells like phosphor. Your body is weightless.

An empty picture floats in the space.

You remember when he bought the jacket. You were in London, visiting for the first time, and he got an idea that jackets were cheaper in Britain. He was wrong, but he insisted.

* * *

>photograph jacket
*click*
the jacket is photographed. The camera whirs.

>n
Living Room
The most prominent element in the living room was always the old dining table

You used to remember the story of how he got it. It was something to do with a misunderstanding. And a mistyped phone number.

A picture is stuck in the corner.

You can also see a book and Shelves here.

>photograph shelves
*click*
Shelves is photographed. The camera whirs.

>touch camera
Inside the Camera
Your vision is overtaken by dust and film. It smells like phosphor. Your body is weightless.

An empty picture floats in the space.

You remember when he bought the jacket. You were in London, visiting for the first time, and he got an idea that jackets were cheaper in Britain. He was wrong, but he insisted. You followed him, dutifully, shaking your head all the way. Although, you will admit, he got a pretty darn good jacket out of it.

All the books. He kept all the books, the mad man. I sold mine after we were done.

* * *

>open camera
Inside the Camera
Your vision is overtaken by dust and film. It smells like phosphor. Your body is weightless. As all good stories, this one has a beginning, a middle, and an end.

An empty picture floats in the space.

You feel as if you can change a setting, to change the time.

There are memories from each part of your life, the beginning, middle, and end. The setting governs which ones you are seeing at the moment. There are more than 1 memory in each part, though, so stick around (and examine elements of the memories) to see the others.

>open camera
Entrance
The Entrance. The shoerack is the same, albeit a bit more dusty than you remember it.

One pair of shoes. Good as new.

A jacket hangs on the coathanger. It's his, you'd recognize it anywhere.

* * *

>open camera
Inside the Camera
Your vision is overtaken by dust and film. It smells like phosphor. Your body is weightless. As all good stories, this one has a beginning, a middle, and an end.

An empty picture floats in the space.

You feel as if you can change a setting, to change the time.

There are memories from each part of your life, the beginning, middle, and end. The setting governs which ones you are seeing at the moment. There are more than 1 memory in each part, though, so stick around (and examine elements of the memories) to see the others.

>close camera
Entrance
The Entrance. The shoerack is the same, albeit a bit more dusty than you remember it.

One pair of shoes. Good as new.

A jacket hangs on the coathanger. It's his, you'd recognize it anywhere.

>photograph shoerack
*click*
the shoerack is photographed. The camera whirs.

>open camera
Inside the Camera
Your vision is overtaken by dust and film. It smells like phosphor. Your body is weightless. As all good stories, this one has a beginning, a middle, and an end.

An empty picture floats in the space.

"You two, you're together", the teacher said. And we were, apparently. I had never met him before, but there we were, suddenly, forced to work together.

>wait
Time passes.

>wait
Time passes.

We had our fights, sure. It's hazy, now, to even remember what they were about. I remember throwing a shoe, once.

"You two, you're together", the teacher said. And we were, apparently. I had never met him before, but there we were, suddenly, forced to work together.

* * *

>wait
Time passes.

"You two, you're together", the teacher said. And we were, apparently. I had never met him before, but there we were, suddenly, forced to work together.

But before we knew it, we graduated. Together.

>wait
Time passes.

* * *

>close camera
Entrance
The Entrance. The shoerack is the same, albeit a bit more dusty than you remember it.

One pair of shoes. Good as new.

A jacket hangs on the coathanger. It's his, you'd recognize it anywhere.

>open camera
Inside the Camera
Your vision is overtaken by dust and film. It smells like phosphor. Your body is weightless. As all good stories, this one has a beginning, a middle, and an end.

An empty picture floats in the space.

You feel as if you can change the world as if you were to change a setting.

* * *

>open camera
Inside the Camera
Your vision is overtaken by dust and film. It smells like phosphor. Your body is weightless. As all good stories, this one has a beginning, a middle, and an end.

An empty picture floats in the space.

You feel as if you can change a setting, to change the time.

There are memories from each part of your life, the beginning, middle, and end. The setting governs which ones you are seeing at the moment. There are more than 1 memory in each part, though, so stick around (and examine elements of the memories) to see the others.

>down
The Beginning

>forwards
Middle

>forwards
End

>backwards
Middle

>backwards
The Beginning

>up
Inside the Camera
Your vision is overtaken by dust and film. It smells like phosphor. Your body is weightless. As all good stories, this one has a beginning, a middle, and an end.

An empty picture floats in the space.

* * *

>open camera
Inside the Camera
Your vision is overtaken by dust and film. It smells like phosphor. Your body is weightless. As all good stories, this one has a beginning, a middle, and an end.

An empty picture floats in the space.

You feel as if you can change a setting, to change the time.

There are memories from each part of your life, the beginning, middle, and end. The setting governs which ones you are seeing at the moment. There are more than 1 memory in each part, though, so stick around (and examine elements of the memories) to see the others.

>change setting
The world shifts to the middle

>close camera
Entrance
The Entrance. The shoerack is the same, albeit a bit more dusty than you remember it.

One pair of shoes. Good as new.

A jacket hangs on the coathanger. It's his, you'd recognize it anywhere.

>p shoerack
*click*
the shoerack is photographed. The camera whirs.

>open camera
Inside the Camera
Your vision is overtaken by dust and film. It smells like phosphor. Your body is weightless. As all good stories, this one has a beginning, a middle, and an end.

An empty picture floats in the space.

You feel as if you can change the world as if you were to change a setting.

>change setting
The world shifts to the end

>change setting
The world is beginning again
 A scene fills the space.  A classroom. A teacher. You're sitting in the back, another 50 students or so, spread around the auditorium. It's new and too clean. The blackboard's barely been written on. 
 "You two, you're together", the teacher said. And you were, apparently. You had never met him before, but there you were, suddenly, forced to work together.

>change setting
The world shifts to the middle

>change setting
The world shifts to the end
The scene shifts. You're in a group room, walls covered in post-it notes. You're both staring at our monitors, working out some problem. As you always did. 
You had your fights, sure. It's hazy, now, to even remember what they were about. You remember throwing a shoe, once.

>change setting
The world is beginning again

>change setting
The world shifts to the middle

>change setting
The world shifts to the end
The scene shifts. Before you knew it, you graduated. Together. The ceremony wasn't the fun part, but you did it.

* * *

>open camera
Inside the Camera
Your vision is overtaken by dust and film. It smells like phosphor. Your body is weightless. As all good stories, this one has a beginning, a middle, and an end.

An empty picture floats in the space.

You feel as if you can change a setting, to change the time.

There are memories from each part of your life, the beginning, middle, and end. The setting governs which ones you are seeing at the moment. There are more than 1 memory in each part, though, so stick around (and examine elements of the memories) to see the others.

>take setting
That's fixed in place.

>change setting
The world shifts to the middle

* * *

>open camera
Inside the Camera
Your vision is overtaken by dust and film. It smells like phosphor. Your body is weightless. As all good stories, this one has a beginning, a middle, and an end.

An empty picture floats in the space.

You feel as if you can change a setting, to change the time.

There are memories from each part of your life, the beginning, middle, and end. The setting governs which ones you are seeing at the moment. There are more than 1 memory in each part, though, so stick around (and examine elements of the memories) to see the others.

>x picture
It is not entirely empty, upon inspection. There are some objects. A shirt? A raincoat? And dirt? Footprints? And words, lots of words. They are all fading in and out, difficult to tell apart, yet distinct.

* * *

>change setting
The world shifts to the middle

>change setting
The world shifts to the end

>change setting
The world is beginning again

>z
Time passes.

>z
Time passes.

* * *

>x picture
It is not entirely empty, upon inspection. There are some objects. A shirt? A raincoat? And dirt? Footprints? And words, lots of words. They are all fading in and out, difficult to tell apart, yet distinct.

>close camear
You can't see any such thing.

>close camera
Entrance
The Entrance. The shoerack is the same, albeit a bit more dusty than you remember it. 
Further north is a living room, and up the stairs is a hallway above.

A shoerack. Good as new, and empty.

A jacket hangs on the coathanger. It's his, you'd recognize it anywhere.

>p shoerack
*click*
the shoerack is photographed. The camera whirs.

>open camera
Inside the Camera
Your vision is overtaken by dust and film. It smells like phosphor. Your body is weightless. As all good stories, this one has a beginning, a middle, and an end.

An empty picture floats in the space.

You feel as if you can change a setting, to change the time.

 A scene fills the space.  A classroom. A teacher. You're sitting in the back, another 50 students or so, spread around the auditorium. It's new and too clean. The blackboard's barely been written on. 
 "You two, you're together", the teacher said. And you were, apparently. You had never met him before, but there you were, suddenly, forced to work together.

>change setting
The world shifts to the middle

>z
Time passes.

I beg your pardon?

>z
Time passes.

>close camera
Entrance
The Entrance. The shoerack is the same, albeit a bit more dusty than you remember it. 
Further north is a living room, and up the stairs is a hallway above.

A shoerack. Good as new, and empty.

A jacket hangs on the coathanger. It's his, you'd recognize it anywhere.

* * *

>x picture
It is not entirely empty, upon inspection. There are some objects. A shirt? A raincoat? And dirt? Footprints? And words, lots of words. They are all fading in and out, difficult to tell apart, yet distinct.

>change setting
The world shifts to the middle

>close camera
Entrance
The Entrance. The shoerack is the same, albeit a bit more dusty than you remember it. 
Further north is a living room, and up the stairs is a hallway above.

A shoerack. Good as new, and empty.

A jacket hangs on the coathanger. It's his, you'd recognize it anywhere.

* * *

>p shoerack
*click*
the shoerack is photographed. The camera whirs.

>open camera
Inside the Camera
Your vision is overtaken by dust and film. It smells like phosphor. Your body is weightless. As all good stories, this one has a beginning, a middle, and an end.

An empty picture floats in the space.

You feel as if you can change a setting, to change the time.

>x picture
The empty picture shows an outline of some clothing. A shirt? A raincoat?
Documents, scattered on the table. Crossed out words, highlight markers.

* * *

>photogrpah jacket
That's not a verb I recognise.

>photograph jacket
*click*
the jacket is photographed. The camera whirs.

>open camera
Inside the Camera
Your vision is overtaken by dust and film. It smells like phosphor. Your body is weightless. As all good stories, this one has a beginning, a middle, and an end.

An empty picture floats in the space.

"You two, you're together", the teacher said. And we were, apparently. I had never met him before, but there we were, suddenly, forced to work together.

* * *

>wait
Time passes.

>wait
Time passes.

We had our fights, sure. It's hazy, now, to even remember what they were about. 
"You two, you're together", the teacher said. And we were, apparently. I had never met him before, but there we were, suddenly, forced to work together.

* * *

>p shoerack
*click*
the shoerack is photographed. The camera whirs.

>open camera
Inside the Camera
Your vision is overtaken by dust and film. It smells like phosphor. Your body is weightless. As all good stories, this one has a beginning, a middle, and an end.

An empty picture floats in the space.

You feel as if you can change a setting, to change the time.

There are memories from each part of your life, the beginning, middle, and end. The setting governs which ones you are seeing at the moment. There are more than 1 memory in each part, though, so stick around (and examine elements of the memories) to see the others.

 A scene fills the space.  A classroom. A teacher. You're sitting in the back, another 50 students or so, spread around the auditorium. It's new and too clean. The blackboard's barely been written on. 
 "You two, you're together", the teacher said. And you were, apparently. You had never met him before, but there you were, suddenly, forced to work together.

>wait
Time passes.

>wait
Time passes.

The scene shifts. You're in a group room, walls covered in post-it notes. You're both staring at our monitors, working out some problem. As you always did. 
You had your fights, sure. It's hazy, now, to even remember what they were about. You remember throwing a shoe, once.

>examine shoe
It was about some disagreement over a figure, or something equally stupid. You wanted it, he didn't. It got heated, and the shoe sort of fell off.

>close camera
Entrance
The Entrance. The shoerack is the same, albeit a bit more dusty than you remember it.

One pair of shoes. Good as new.

A jacket hangs on the coathanger. It's his, you'd recognize it anywhere.

>n
Living Room
The most prominent element in the living room was always the old dining table

You used to remember the story of how he got it. It was something to do with a misunderstanding. And a mistyped phone number.

A picture is stuck in the corner.

You can also see a book, Shelves and a project report here.

The scene shifts. Before you knew it, you graduated. Together. The ceremony wasn't the fun part, but you did it.

>s
Entrance
The Entrance. The shoerack is the same, albeit a bit more dusty than you remember it.

One pair of shoes. Good as new.

A jacket hangs on the coathanger. It's his, you'd recognize it anywhere.

>open camera
Inside the Camera
Your vision is overtaken by dust and film. It smells like phosphor. Your body is weightless. As all good stories, this one has a beginning, a middle, and an end.

An empty picture floats in the space.

>w
You can't go that way.

 The scene shifts back.  A classroom. A teacher. You're sitting in the back, another 50 students or so, spread around the auditorium. It's new and too clean. The blackboard's barely been written on. 
 "You two, you're together", the teacher said. And you were, apparently. You had never met him before, but there you were, suddenly, forced to work together.

>close camera
Entrance
The Entrance. The shoerack is the same, albeit a bit more dusty than you remember it.

One pair of shoes. Good as new.

A jacket hangs on the coathanger. It's his, you'd recognize it anywhere.

>open camera
Inside the Camera
Your vision is overtaken by dust and film. It smells like phosphor. Your body is weightless. As all good stories, this one has a beginning, a middle, and an end.

An empty picture floats in the space.

You can also see a students and a teacher here.

>close camera
Entrance
The Entrance. The shoerack is the same, albeit a bit more dusty than you remember it.

One pair of shoes. Good as new.

A jacket hangs on the coathanger. It's his, you'd recognize it anywhere.

The scene shifts. You're in a group room, walls covered in post-it notes. You're both staring at our monitors, working out some problem. As you always did. 
You had your fights, sure. It's hazy, now, to even remember what they were about. You remember throwing a shoe, once.

>open camera
Inside the Camera
Your vision is overtaken by dust and film. It smells like phosphor. Your body is weightless. As all good stories, this one has a beginning, a middle, and an end.

An empty picture floats in the space.

You can also see a shoe and a post-it notes here.

* * *

>w
You can't go that way.

>w
You can't go that way.

The scene shifts. You're in a group room, walls covered in post-it notes. You're both staring at our monitors, working out some problem. As you always did. 
You had your fights, sure. It's hazy, now, to even remember what they were about. You remember throwing a shoe, once.

>wait
Time passes.

>wait
Time passes.

The scene shifts. Before you knew it, you graduated. Together. The ceremony wasn't the fun part, but you did it.

>z
Time passes.

>z
Time passes.

 The scene shifts back.  A classroom. A teacher. You're sitting in the back, another 50 students or so, spread around the auditorium. It's new and too clean. The blackboard's barely been written on. 
 "You two, you're together", the teacher said. And you were, apparently. You had never met him before, but there you were, suddenly, forced to work together.

>close
(the camera)
Entrance
The Entrance. The shoerack is the same, albeit a bit more dusty than you remember it.

One pair of shoes. Good as new.

A jacket hangs on the coathanger. It's his, you'd recognize it anywhere.

>open camera
Inside the Camera
Your vision is overtaken by dust and film. It smells like phosphor. Your body is weightless. As all good stories, this one has a beginning, a middle, and an end.

An empty picture floats in the space.

You feel as if you can change the world as if you were to change a setting.

You can also see a students and a teacher here.

>change setting
The world shifts to the middle
The scene shifts. You're in a group room, walls covered in post-it notes. You're both staring at our monitors, working out some problem. As you always did. 
You had your fights, sure. It's hazy, now, to even remember what they were about. You remember throwing a shoe, once.

* * *

>z
Time passes.

>z
Time passes.

The scene shifts. You're in a group room, walls covered in post-it notes. You're both staring at our monitors, working out some problem. As you always did. 
You had your fights, sure. It's hazy, now, to even remember what they were about. You remember throwing a shoe, once.

>z
Time passes.

>z
Time passes.

The scene shifts. The scene shifts. Before you knew it, you graduated. Together. The ceremony wasn't the fun part, but you did it.

>z
Time passes.

>change setting
The world shifts to the middle

* * *

>z
Time passes.

>actions
Actions listing on.

>z
[waiting]
Time passes.
[waiting - succeeded]

A classroom. A teacher. You're sitting in the back, another 50 students or so, spread around the auditorium. It's new and too clean. The blackboard's barely been written on. 
 "You two, you're together", the teacher said. And you were, apparently. You had never met him before, but there you were, suddenly, forced to work together. 
setting is BEGINNING!

>change setting
[changing the setting]
The world shifts to the middle[changing the setting - succeeded]

>change setting
[changing the setting]
The world shifts to the end[changing the setting - succeeded]

>change setting
[changing the setting]
The world is beginning again[changing the setting - succeeded]

A classroom. A teacher. You're sitting in the back, another 50 students or so, spread around the auditorium. It's new and too clean. The blackboard's barely been written on. 
 "You two, you're together", the teacher said. And you were, apparently. You had never met him before, but there you were, suddenly, forced to work together. 
setting is BEGINNING!

* * *

>z
Time passes.

 The scene shifts back.  A classroom. A teacher. You're sitting in the back, another 50 students or so, spread around the auditorium. It's new and too clean. The blackboard's barely been written on. 
 "You two, you're together", the teacher said. And you were, apparently. You had never met him before, but there you were, suddenly, forced to work together.

>z
Time passes.

A classroom. A teacher. You're sitting in the back, another 50 students or so, spread around the auditorium. It's new and too clean. The blackboard's barely been written on. 
 "You two, you're together", the teacher said. And you were, apparently. You had never met him before, but there you were, suddenly, forced to work together. 
setting is BEGINNING!

>change setting
The world shifts to the middle

>z
Time passes.

Part One ENDS

>z
Time passes.

>change setting
The world shifts to the end

>z
Time passes.

>change  setting
The world is beginning again
 The scene shifts back.  
A classroom. A teacher. You're sitting in the back, another 50 students or so, spread around the auditorium. It's new and too clean. The blackboard's barely been written on. 
 "You two, you're together", the teacher said. And you were, apparently. You had never met him before, but there you were, suddenly, forced to work together. 
setting is BEGINNING!

* * *

>z
Time passes.

 The scene shifts back.  A classroom. A teacher. You're sitting in the back, another 50 students or so, spread around the auditorium. It's new and too clean. The blackboard's barely been written on. 
 "You two, you're together", the teacher said. And you were, apparently. You had never met him before, but there you were, suddenly, forced to work together.

>change setting
The world shifts to the middle

* * *

>z
Time passes.

>change setting
The world is beginning again
 The scene shifts back.  A classroom. A teacher. You're sitting in the back, another 50 students or so, spread around the auditorium. It's new and too clean. The blackboard's barely been written on. 
 "You two, you're together", the teacher said. And you were, apparently. You had never met him before, but there you were, suddenly, forced to work together.

>z
Time passes.

>close camera
Entrance
The Entrance. The shoerack is the same, albeit a bit more dusty than you remember it.

One pair of shoes. Good as new.

A jacket hangs on the coathanger. It's his, you'd recognize it anywhere.

>z
Time passes.

>open camera
Inside the Camera
Your vision is overtaken by dust and film. It smells like phosphor. Your body is weightless. As all good stories, this one has a beginning, a middle, and an end.

An empty picture floats in the space.

You feel as if you can change the world as if you were to change a setting.

You can also see a shoe and a post-it notes here.

>z
Time passes.

 The scene shifts back.  A classroom. A teacher. You're sitting in the back, another 50 students or so, spread around the auditorium. It's new and too clean. The blackboard's barely been written on. 
 "You two, you're together", the teacher said. And you were, apparently. You had never met him before, but there you were, suddenly, forced to work together.

>z
Time passes.

* * *

>z
Time passes.

 The scene shifts back.  A classroom. A teacher. You're sitting in the back, another 50 students or so, spread around the auditorium. It's new and too clean. The blackboard's barely been written on. 
 "You two, you're together", the teacher said. And you were, apparently. You had never met him before, but there you were, suddenly, forced to work together.

>close camera
Entrance
The Entrance. The shoerack is the same, albeit a bit more dusty than you remember it.

One pair of shoes. Good as new.

A jacket hangs on the coathanger. It's his, you'd recognize it anywhere.

* * *

>z
Time passes.

>open camera
Inside the Camera
Your vision is overtaken by dust and film. It smells like phosphor. Your body is weightless. As all good stories, this one has a beginning, a middle, and an end.

An empty picture floats in the space.

You feel as if you can change the world as if you were to change a setting.

You can also see a students and a teacher here.

The scene shifts. The scene shifts. Before you knew it, you graduated. Together. The ceremony wasn't the fun part, but you did it.

>z
Time passes.

>open camera
Inside the Camera
Your vision is overtaken by dust and film. It smells like phosphor. Your body is weightless. As all good stories, this one has a beginning, a middle, and an end.

An empty picture floats in the space.

You feel as if you can change the world as if you were to change a setting.

You can also see a students and a teacher here.

>z
Time passes.

The scene shifts. The scene shifts. Before you knew it, you graduated. Together. The ceremony wasn't the fun part, but you did it.

>close camera
Entrance
The Entrance. The shoerack is the same, albeit a bit more dusty than you remember it.

One pair of shoes. Good as new.

A jacket hangs on the coathanger. It's his, you'd recognize it anywhere.

>open camera
Inside the Camera
Your vision is overtaken by dust and film. It smells like phosphor. Your body is weightless. As all good stories, this one has a beginning, a middle, and an end.

An empty picture floats in the space.

You feel as if you can change the world as if you were to change a setting.

You can also see a students and a teacher here.

* * *

>z
Time passes.

The scene shifts. The scene shifts. Before you knew it, you graduated. Together. The ceremony wasn't the fun part, but you did it.

>change setting
The world shifts to the middle

* * *

>z
Time passes.

 The scene shifts back.  A classroom. A teacher. You're sitting in the back, another 50 students or so, spread around the auditorium. It's new and too clean. The blackboard's barely been written on. 
 "You two, you're together", the teacher said. And you were, apparently. You had never met him before, but there you were, suddenly, forced to work together.

I beg your pardon?

* * *

>close camera
Entrance
The Entrance. The shoerack is the same, albeit a bit more dusty than you remember it.

One pair of shoes. Good as new.

A jacket hangs on the coathanger. It's his, you'd recognize it anywhere.

>open camera
Inside the Camera
Your vision is overtaken by dust and film. It smells like phosphor. Your body is weightless. As all good stories, this one has a beginning, a middle, and an end.

An empty picture floats in the space.

You feel as if you can change the world as if you were to change a setting.

The scene shifts. You're in a group room, walls covered in post-it notes. You're both staring at our monitors, working out some problem. As you always did. 
You had your fights, sure. It's hazy, now, to even remember what they were about. You remember throwing a shoe, once.

>z
Time passes.

>scenes
Scene 'Entire Game' playing (for 24 mins now)
Scene 'Beginning Memory Part One' ended happily
Scene 'Beginning Memory Part Two' playing (for 1 mins now)
Scene 'Beginning Memory Part Three' ended happily
(Scene monitoring now switched on. Type "scenes off" to switch it off again.)

* * *

>z
Time passes.

>scenes
Scene 'Entire Game' playing (for 5 mins now)
(Scene monitoring now switched on. Type "scenes off" to switch it off again.)

* * *

>z
Time passes.

>take picture
Taken.

A classroom. A teacher. You're sitting in the back, another 50 students or so, spread around the auditorium. It's new and too clean. The blackboard's barely been written on. 
 "You two, you're together", the teacher said. And you were, apparently. You had never met him before, but there you were, suddenly, forced to work together. 
setting is BEGINNING!

>z
Time passes.

A classroom. A teacher. You're sitting in the back, another 50 students or so, spread around the auditorium. It's new and too clean. The blackboard's barely been written on. 
 "You two, you're together", the teacher said. And you were, apparently. You had never met him before, but there you were, suddenly, forced to work together. 
setting is BEGINNING!

The scene shifts.

Part One ENDS

>z
Time passes.

You're in a group room, walls covered in post-it notes. You're both staring at our monitors, working out some problem. As you always did. 
You had your fights, sure. It's hazy, now, to even remember what they were about. You remember throwing a shoe, once. 
setting is BEGINNING!

* * *

>z
Time passes.

The scene shifts. You're in a group room, walls covered in post-it notes. You're both staring at our monitors, working out some problem. As you always did. 
You had your fights, sure. It's hazy, now, to even remember what they were about. You remember throwing a shoe, once.

>change setting
The world shifts to the middle

><
That's not a verb I recognise.

>z
Time passes.

* * *

>change setting
The world shifts to the end

>change setting
The world is beginning again
 The scene shifts back.  A classroom. A teacher. You're sitting in the back, another 50 students or so, spread around the auditorium. It's new and too clean. The blackboard's barely been written on. 
 "You two, you're together", the teacher said. And you were, apparently. You had never met him before, but there you were, suddenly, forced to work together.

* * *

>change setting
The world shifts to the end

>change setting
The world is beginning again
A classroom. A teacher. You're sitting in the back, another 50 students or so, spread around the auditorium. It's new and too clean. The blackboard's barely been written on. 
 "You two, you're together", the teacher said. And you were, apparently. You had never met him before, but there you were, suddenly, forced to work together.

>z
Time passes.

A classroom. A teacher. You're sitting in the back, another 50 students or so, spread around the auditorium. It's new and too clean. The blackboard's barely been written on. 
 "You two, you're together", the teacher said. And you were, apparently. You had never met him before, but there you were, suddenly, forced to work together.

>z
Time passes.

A classroom. A teacher. You're sitting in the back, another 50 students or so, spread around the auditorium. It's new and too clean. The blackboard's barely been written on. 
 "You two, you're together", the teacher said. And you were, apparently. You had never met him before, but there you were, suddenly, forced to work together.

>close camera
Entrance
The Entrance. The shoerack is the same, albeit a bit more dusty than you remember it.

One pair of shoes. Good as new.

A jacket hangs on the coathanger. It's his, you'd recognize it anywhere.

* * *

>z
Time passes.

>oh
That's not a verb I recognise.

>open camera
Inside the Camera
Your vision is overtaken by dust and film. It smells like phosphor. Your body is weightless. As all good stories, this one has a beginning, a middle, and an end.

An empty picture floats in the space.

You feel as if you can change the world as if you were to change a setting.

You can also see a students and a teacher here.

A classroom. A teacher. You're sitting in the back, another 50 students or so, spread around the auditorium. It's new and too clean. The blackboard's barely been written on. 
 "You two, you're together", the teacher said. And you were, apparently. You had never met him before, but there you were, suddenly, forced to work together.

>z
Time passes.

A classroom. A teacher. You're sitting in the back, another 50 students or so, spread around the auditorium. It's new and too clean. The blackboard's barely been written on. 
 "You two, you're together", the teacher said. And you were, apparently. You had never met him before, but there you were, suddenly, forced to work together.

I beg your pardon?

>z
Time passes.

A classroom. A teacher. You're sitting in the back, another 50 students or so, spread around the auditorium. It's new and too clean. The blackboard's barely been written on. 
 "You two, you're together", the teacher said. And you were, apparently. You had never met him before, but there you were, suddenly, forced to work together.

* * *

>z
Time passes.

>p picture
you have no hands with which to use an object you are inside. Even the sentence refuses to make sense.

A classroom. A teacher. You're sitting in the back, another 50 students or so, spread around the auditorium. It's new and too clean. The blackboard's barely been written on. 
 "You two, you're together", the teacher said. And you were, apparently. You had never met him before, but there you were, suddenly, forced to work together. 
setting is BEGINNING!

>z
Time passes.

A classroom. A teacher. You're sitting in the back, another 50 students or so, spread around the auditorium. It's new and too clean. The blackboard's barely been written on. 
 "You two, you're together", the teacher said. And you were, apparently. You had never met him before, but there you were, suddenly, forced to work together. 
setting is BEGINNING!

>z
Time passes.

A classroom. A teacher. You're sitting in the back, another 50 students or so, spread around the auditorium. It's new and too clean. The blackboard's barely been written on. 
 "You two, you're together", the teacher said. And you were, apparently. You had never met him before, but there you were, suddenly, forced to work together. 
setting is BEGINNING!

>rules
Rules tracing now switched on. Type "rules off" to switch it off again, or "rules all" to include even rules which do not apply.

>z
[Rule "declare everything initially unmentioned rule" applies.]
[Rule "announce items from multiple object lists rule" applies.]
[Rule "set pronouns from items from multiple object lists rule" applies.]
[Rule "before stage rule" applies.]
[Rule "instead stage rule" applies.]
[Rule "investigate player's awareness before action rule" applies.]
[Rule "player aware of his own actions rule" applies.]
[Rule "check stage rule" applies.]
[Rule "carry out stage rule" applies.]
[Rule "after stage rule" applies.]
[Rule "investigate player's awareness after action rule" applies.]
[Rule "report stage rule" applies.]
[Rule "standard report waiting rule" applies.]
Time passes.
[Rule "last specific action-processing rule" applies.]

[Rule "A first turn sequence rule" applies.]
[Rule "every turn stage rule" applies.]
[Rule "Every turn during the Beginning Memory Part One" applies.]
A classroom. A teacher. You're sitting in the back, another 50 students or so, spread around the auditorium. It's new and too clean. The blackboard's barely been written on. 
 "You two, you're together", the teacher said. And you were, apparently. You had never met him before, but there you were, suddenly, forced to work together. 
[Rule "Every turn" applies.]
setting is BEGINNING!

[Rule "A last turn sequence rule" applies.]
[Rule "notify score changes rule" applies.]

* * *

>z
Time passes.

>take picture
Taken.

A classroom. A teacher. You're sitting in the back, another 50 students or so, spread around the auditorium. It's new and too clean. The blackboard's barely been written on. 
 "You two, you're together", the teacher said. And you were, apparently. You had never met him before, but there you were, suddenly, forced to work together. 
setting is BEGINNING!

Part One ENDS
The scene shifts.

>z
Time passes.

You're in a group room, walls covered in post-it notes. You're both staring at our monitors, working out some problem. As you always did. 
You had your fights, sure. It's hazy, now, to even remember what they were about. You remember throwing a shoe, once. 
setting is BEGINNING!

* * *

>change setting
The world shifts to the end

>change setting
The world is beginning again
 A scene fills the space.  
A classroom. A teacher. You're sitting in the back, another 50 students or so, spread around the auditorium. It's new and too clean. The blackboard's barely been written on. 
 "You two, you're together", the teacher said. And you were, apparently. You had never met him before, but there you were, suddenly, forced to work together. 
setting is BEGINNING!

>change setting
The world shifts to the middle

* * *

>change setting
The world shifts to the end

>change setting
The world is beginning again
A classroom. A teacher. You're sitting in the back, another 50 students or so, spread around the auditorium. It's new and too clean. The blackboard's barely been written on. 
 "You two, you're together", the teacher said. And you were, apparently. You had never met him before, but there you were, suddenly, forced to work together. 
setting is BEGINNING!

>z
Time passes.

A classroom. A teacher. You're sitting in the back, another 50 students or so, spread around the auditorium. It's new and too clean. The blackboard's barely been written on. 
 "You two, you're together", the teacher said. And you were, apparently. You had never met him before, but there you were, suddenly, forced to work together. 
setting is BEGINNING!

* * *

>change setting
The world is beginning again
 A scene fills the space.  
A classroom. A teacher. You're sitting in the back, another 50 students or so, spread around the auditorium. It's new and too clean. The blackboard's barely been written on. 
 "You two, you're together", the teacher said. And you were, apparently. You had never met him before, but there you were, suddenly, forced to work together. 
setting is BEGINNING!

>z
Time passes.

A classroom. A teacher. You're sitting in the back, another 50 students or so, spread around the auditorium. It's new and too clean. The blackboard's barely been written on. 
 "You two, you're together", the teacher said. And you were, apparently. You had never met him before, but there you were, suddenly, forced to work together. 
setting is BEGINNING!

>scenes
Scene 'Entire Game' playing (for 5 mins now)
Scene 'Beginning Memory Part One' playing (for 2 mins now)
(Scene monitoring now switched on. Type "scenes off" to switch it off again.)

>z
Time passes.

A classroom. A teacher. You're sitting in the back, another 50 students or so, spread around the auditorium. It's new and too clean. The blackboard's barely been written on. 
 "You two, you're together", the teacher said. And you were, apparently. You had never met him before, but there you were, suddenly, forced to work together. 
setting is BEGINNING!

>scenes
Scene 'Entire Game' playing (for 6 mins now)
Scene 'Beginning Memory Part One' playing (for 3 mins now)
(Scene monitoring now switched on. Type "scenes off" to switch it off again.)

>showme
Inside the Camera - room
    students
    teacher
    yourself - person
        camera
    empty picture
    setting

>showme setting
setting - thing
location: in Inside the Camera
singular-named, improper-named; unlit, inedible, portable, not photographed
list grouping key: none
printed name: "setting"
printed plural name: none
indefinite article: none
description: none
initial appearance: "You feel as if you can change the world as if you were to change a setting."
setting condition: beginning

* * *

>rules
Rules tracing now switched on. Type "rules off" to switch it off again, or "rules all" to include even rules which do not apply.

* * *

>p picture
[Rule "declare everything initially unmentioned rule" applies.]
[Rule "announce items from multiple object lists rule" applies.]
[Rule "set pronouns from items from multiple object lists rule" applies.]
[Rule "before stage rule" applies.]
[Rule "instead stage rule" applies.]
[Rule "investigate player's awareness before action rule" applies.]
[Rule "player aware of his own actions rule" applies.]
[Rule "check stage rule" applies.]
[Rule "Check photographing" applies.]
you have no hands with which to use an object you are inside. Even the sentence refuses to make sense.

[Rule "A first turn sequence rule" applies.]
[Rule "every turn stage rule" applies.]
[Rule "Every turn during the Beginning Memory Part One" applies.]
A classroom. A teacher. You're sitting in the back, another 50 students or so, spread around the auditorium. It's new and too clean. The blackboard's barely been written on. 
 "You two, you're together", the teacher said. And you were, apparently. You had never met him before, but there you were, suddenly, forced to work together. 
[Rule "Every turn" applies.]
setting is BEGINNING!

[Rule "A last turn sequence rule" applies.]
[Rule "notify score changes rule" applies.]

>take picture
[Rule "declare everything initially unmentioned rule" applies.]
[Rule "announce items from multiple object lists rule" applies.]
[Rule "set pronouns from items from multiple object lists rule" applies.]
[Rule "before stage rule" applies.]
[Rule "instead stage rule" applies.]
[Rule "investigate player's awareness before action rule" applies.]
[Rule "player aware of his own actions rule" applies.]
[Rule "check stage rule" applies.]
[Rule "can't take yourself rule" applies.]
[Rule "can't take other people rule" applies.]
[Rule "can't take component parts rule" applies.]
[Rule "can't take people's possessions rule" applies.]
[Rule "can't take items out of play rule" applies.]
[Rule "can't take what you're inside rule" applies.]
[Rule "can't take what's already taken rule" applies.]
[Rule "can't take scenery rule" applies.]
[Rule "can only take things rule" applies.]
[Rule "can't take what's fixed in place rule" applies.]
[Rule "use player's holdall to avoid exceeding carrying capacity rule" applies.]
[Rule "can't exceed carrying capacity rule" applies.]
[Rule "carry out stage rule" applies.]
[Rule "standard taking rule" applies.]
[Rule "after stage rule" applies.]
[Rule "investigate player's awareness after action rule" applies.]
[Rule "report stage rule" applies.]
[Rule "standard report taking rule" applies.]
Taken.
[Rule "last specific action-processing rule" applies.]

[Rule "A first turn sequence rule" applies.]
[Rule "every turn stage rule" applies.]
[Rule "Every turn during the Beginning Memory Part One" applies.]
A classroom. A teacher. You're sitting in the back, another 50 students or so, spread around the auditorium. It's new and too clean. The blackboard's barely been written on. 
 "You two, you're together", the teacher said. And you were, apparently. You had never met him before, but there you were, suddenly, forced to work together. 
[Rule "Every turn" applies.]
setting is BEGINNING!

[Rule "A last turn sequence rule" applies.]
[Rule "notify score changes rule" applies.]

>rules
[Rule "declare everything initially unmentioned rule" applies.]
Rules tracing now switched on. Type "rules off" to switch it off again, or "rules all" to include even rules which do not apply.

* * *

>close camera
Entrance
The Entrance. The shoerack is the same, albeit a bit more dusty than you remember it.

One pair of shoes. Good as new.

A jacket hangs on the coathanger. It's his, you'd recognize it anywhere.

>open camera
Inside the Camera
Your vision is overtaken by dust and film. It smells like phosphor. Your body is weightless. As all good stories, this one has a beginning, a middle, and an end.

An empty picture floats in the space.

You feel as if you can change the world as if you were to change a setting.

You can also see a students and a teacher here.

The scene shifts. You're in a group room, walls covered in post-it notes. You're both staring at our monitors, working out some problem. As you always did. 
You had your fights, sure. It's hazy, now, to even remember what they were about. You remember throwing a shoe, once.

>z
Time passes.

* * *

>close camera
Entrance
The Entrance. The shoerack is the same, albeit a bit more dusty than you remember it.

One pair of shoes. Good as new.

A jacket hangs on the coathanger. It's his, you'd recognize it anywhere.

>open camera
Inside the Camera
Your vision is overtaken by dust and film. It smells like phosphor. Your body is weightless. As all good stories, this one has a beginning, a middle, and an end.

An empty picture floats in the space.

You feel as if you can change the world as if you were to change a setting.

You can also see a shoe and a post-it notes here.

The scene shifts. The scene shifts. Before you knew it, you graduated. Together. The ceremony wasn't the fun part, but you did it.

>close camera
Entrance
The Entrance. The shoerack is the same, albeit a bit more dusty than you remember it.

One pair of shoes. Good as new.

A jacket hangs on the coathanger. It's his, you'd recognize it anywhere.

* * *

>open camera
Inside the Camera
Your vision is overtaken by dust and film. It smells like phosphor. Your body is weightless. As all good stories, this one has a beginning, a middle, and an end.

An empty picture floats in the space.

You feel as if you can change the world as if you were to change a setting.

>close camera
Entrance
The Entrance. The shoerack is the same, albeit a bit more dusty than you remember it.

One pair of shoes. Good as new.

A jacket hangs on the coathanger. It's his, you'd recognize it anywhere.

* * *

>open camera
Inside the Camera
Your vision is overtaken by dust and film. It smells like phosphor. Your body is weightless. As all good stories, this one has a beginning, a middle, and an end.

An empty picture floats in the space.

You feel as if you can change the world as if you were to change a setting.

>z
Time passes.

* * *

>z
Time passes.

The scene shifts. You're in a group room, walls covered in post-it notes. You're both staring at our monitors, working out some problem. As you always did. 
You had your fights, sure. It's hazy, now, to even remember what they were about. You remember throwing a shoe, once.

>close camera
Entrance
The Entrance. The shoerack is the same, albeit a bit more dusty than you remember it.

One pair of shoes. Good as new.

A jacket hangs on the coathanger. It's his, you'd recognize it anywhere.

>open camera
Inside the Camera
Your vision is overtaken by dust and film. It smells like phosphor. Your body is weightless. As all good stories, this one has a beginning, a middle, and an end.

An empty picture floats in the space.

You feel as if you can change the world as if you were to change a setting.

You can also see a shoe and a post-it notes here.

* * *

>look at teacher
Clara Duvan, her name was. She was a good teacher. Got you through a lot.

>z
Time passes.

The scene shifts. You're in a group room, walls covered in post-it notes. You're both staring at our monitors, working out some problem. As you always did. 
You had your fights, sure. It's hazy, now, to even remember what they were about. You remember throwing a shoe, once.

* * *

>open camera
Inside the Camera
Your vision is overtaken by dust and film. It smells like phosphor. Your body is weightless. As all good stories, this one has a beginning, a middle, and an end.

An empty picture floats in the space.

You feel as if you can change the world as if you were to change a setting.

The scene shifts. You're in a group room, walls covered in post-it notes. You're both staring at our monitors, working out some problem. As you always did. 
You had your fights, sure. It's hazy, now, to even remember what they were about. You remember throwing a shoe, once.

>close camera
Entrance
The Entrance. The shoerack is the same, albeit a bit more dusty than you remember it.

One pair of shoes. Good as new.

A jacket hangs on the coathanger. It's his, you'd recognize it anywhere.

* * *

>open camera
Inside the Camera
Your vision is overtaken by dust and film. It smells like phosphor. Your body is weightless. As all good stories, this one has a beginning, a middle, and an end.

An empty picture floats in the space.

You feel as if you can change the world as if you were to change a setting.

>z
Time passes.

The scene shifts. The scene shifts. Before you knew it, you graduated. Together. The ceremony wasn't the fun part, but you did it.

* * *

>x teacher
Clara Duvan, her name was. She was a good teacher. Got you through a lot.

>x students
There were too many for you to know them all well. You had some friends in there though. So did Frank.

The scene shifts. You're in a group room, walls covered in post-it notes. You're both staring at our monitors, working out some problem. As you always did. 
You had your fights, sure. It's hazy, now, to even remember what they were about. You remember throwing a shoe, once.

>x shoe
It was about some disagreement over a figure, or something equally stupid. You wanted it, he didn't. It got heated, and the shoe sort of... fell off.

>z
Time passes.

>change settin
You can't see any such thing.

>change setting
The world shifts to the end

* * *

>x picture
The empty picture shows an outline of some clothing. A shirt? A raincoat?

>close camera
Entrance
The Entrance. The shoerack is the same, albeit a bit more dusty than you remember it. 
Further north is a living room, and up the stairs is a hallway above.

A shoerack. Good as new, and empty.

A jacket hangs on the coathanger. It's his, you'd recognize it anywhere.

>n
Living Room
The most prominent element in the living room his old dining table. Behind it are stacks of shelves. 
The east opens up to the kitchen. Back south is the entrance.

You can see a dining table (on which is a picture) and shelves (in which are an unmailed letter and a project report) here.

>p report
*click*
the project report is photographed. The camera whirs.

>open camera
Inside the Camera
Your vision is overtaken by dust and film. It smells like phosphor. Your body is weightless. As all good stories, this one has a beginning, a middle, and an end.

An empty picture floats in the space.

You feel as if you can change a setting, to change the time.

The scene shifts. The scene shifts. Before you knew it, you graduated. Together. The ceremony wasn't the fun part, but you did it.  You were damn ragged after staying up all night, fixing commas. But hey, you were alive.

>x picture
The empty picture shows an outline of some clothing. A shirt? A raincoat?
It is empty.

* * *

>x picture
The empty picture shows an outline of some clothing. A shirt? A raincoat?

>change setting
The world shifts to the middle

>x picture
It is vague, but there are shapes in there. Distant and foggy. A book spine. Glints of sharp objects. And a pen and paper? They are all fading in and out, difficult to tell apart, yet distinct.

>change setting
The world shifts to the end

>x picture
There are shapes in there, deformed and uncertain, almost mere coffee stains on print. But some shapes and colors make it through. Green. Memories written down. Strings vibrating. They are all fading in and out, difficult to tell apart, yet distinct.

* * *

>p shoerack
*click*
the shoerack is photographed. The camera whirs.

>z
Time passes.

setting is BEGINNING!

>z
Time passes.

setting is BEGINNING!

>p picture
You can't see any such thing.

>z
Time passes.

setting is BEGINNING!

>open camera
Inside the Camera
Your vision is overtaken by dust and film. It smells like phosphor. Your body is weightless. As all good stories, this one has a beginning, a middle, and an end.

An empty picture floats in the space.

You feel as if you can change the world as if you were to change a setting.

 A scene fills the space.  
A classroom. A teacher. You're sitting in the back, another 50 students or so, spread around the auditorium. It's new and too clean. The blackboard's barely been written on. 
 "You two, you're together", the teacher said. And you were, apparently. You had never met him before, but there you were, suddenly, forced to work together. 
setting is BEGINNING!

>p picture
you have no hands with which to use an object you are inside. Even the sentence refuses to make sense.

A classroom. A teacher. You're sitting in the back, another 50 students or so, spread around the auditorium. It's new and too clean. The blackboard's barely been written on. 
 "You two, you're together", the teacher said. And you were, apparently. You had never met him before, but there you were, suddenly, forced to work together. 
setting is BEGINNING!

* * *

>p shoerack
*click*
the shoerack is photographed. The camera whirs.

>l
Entrance
The Entrance. The shoerack is the same, albeit a bit more dusty than you remember it. 
Further north is a living room, and up the stairs is a hallway above.

One pair of shoes on the rack. Good as new.

A jacket hangs on the coathanger. It's his, you'd recognize it anywhere.

>n
Living Room
The most prominent element in the living room his old dining table. Behind it are stacks of shelves. 
The east opens up to the kitchen. Back south is the entrance.

You can see a dining table (on which is a picture) and shelves (in which are an unmailed letter and a project report) here.

* * *

>p project report
*click*
the project report is photographed. The camera whirs.

>p unmailed letter
*click*
the unmailed letter is photographed. The camera whirs.

>s
Entrance
The Entrance. The shoerack is the same, albeit a bit more dusty than you remember it. 
Further north is a living room, and up the stairs is a hallway above.

One pair of shoes on the rack. Good as new.

A jacket hangs on the coathanger. It's his, you'd recognize it anywhere.

* * *

>up
Hallway
A short hallway, just big enough for two doors. One east, one west.

>e
Bedroom
His bedroom. It's very sparse. 
Back west is the hallway.

A book is on the nightstand.

An unplayed guitar is in the corner.

You can also see a diary (closed) here.

>p guitar
*click*
the guitar is photographed. The camera whirs.

>w
Hallway
A short hallway, just big enough for two doors. One east, one west.

>down
Entrance
The Entrance. The shoerack is the same, albeit a bit more dusty than you remember it. 
Further north is a living room, and up the stairs is a hallway above.

One pair of shoes on the rack. Good as new.

A jacket hangs on the coathanger. It's his, you'd recognize it anywhere.

>leave
But you aren't in anything at the moment.

>go south
You leave the house.

    *** Enough memories for one day. You had hoped to find a concrete answer. 
  Had you just been drifting apart naturally? You still had had some good times. As you think back on it, all your good memories were from school. All that happened after...
 Maybe it was best to just walk away. Leave him in peace. 
You lock the door again and head down the street, camera in hand. At least you have some memories to cling to.  ***

Would you like to RESTART, RESTORE a saved game, QUIT or UNDO the last command?

* * *

>p shoerack
*click*
the shoerack is photographed. The camera whirs.

>p jacket
*click*
the jacket is photographed. The camera whirs.

>n
Living Room
The most prominent element in the living room his old dining table. Behind it are stacks of shelves. 
The east opens up to the kitchen. Back south is the entrance.

You can see a dining table (on which is a picture) and shelves (in which are an unmailed letter and a project report) here.

* * *

>p project report
*click*
the project report is photographed. The camera whirs.

>open camera
Inside the Camera
Your vision is overtaken by dust and film. It smells like phosphor. Your body is weightless. As all good stories, this one has a beginning, a middle, and an end.

An empty picture floats in the space.

You feel as if you can change a setting, to change the time.

There are memories from each part of your life, the beginning, middle, and end. The setting governs which ones you are seeing at the moment. There are more than 1 memory in each part, though, so stick around (and examine elements of the memories) to see the others.

 A scene fills the space.  A classroom. A teacher. You're sitting in the back, another 50 students or so, spread around the auditorium. It's new and too clean. The blackboard's barely been written on. 
 "You two, you're together", the teacher said. And you were, apparently. You had never met him before, but there you were, suddenly, forced to work together.  You remember seeing his jacket in class earlier in the day, thinking he'd be way too flashy to be your friend. Glad you were wrong.

>look at teacher
Clara Duvan, her name was. She was a good teacher. Got you through a lot.

>examine students
There were too many for you to know them all well. You had some friends in there though. So did Frank.

The scene shifts. You're in a group room, walls covered in post-it notes. You're both staring at our monitors, working out some problem. As you always did. 
You had your fights, sure. It's hazy, now, to even remember what they were about. You remember throwing a shoe, once.

>examine post-it notes
They were his idea, mostly. You were never that organized. You tried to follow up, but your mind was always more chaotic than his.

>examine shoe
It was about some disagreement over a figure, or something equally stupid. You wanted it, he didn't. It got heated, and the shoe sort of fell off.

>z
Time passes.

The scene shifts. The scene shifts. Before you knew it, you graduated. Together. The ceremony wasn't the fun part, but you did it.  You were damn ragged after staying up all night, fixing commas. But hey, you were alive.

* * *

>go to middle
You can't see any such thing.

>go to the Middle
You can't see any such thing.

* * *

>look at jacket
You see nothing special about the jacket.

>look at shoerack
You see nothing special about the shoerack.

* * *

>go north
Living Room
The most prominent element in the living room was always the old dining table

You used to remember the story of how he got it. It was something to do with a misunderstanding. And a mistyped phone number.

A picture is stuck in the corner.

You can also see a book, Shelves and a project report here.

>look at picture
It is a picture of your friend, Frank. You don't remember taking this.

* * *

>n
Living Room
The most prominent element in the living room his old dining table. Behind it are stacks of shelves. 
The east opens up to the kitchen. Back south is the entrance.

You can see a dining table (on which is a picture) and shelves (in which are an unmailed letter and a project report) here.

>e
Kitchen
A kitchen, just big enough for another person to squeeze by when one is cooking. The kitchen counters are clean. 
Back west is the living room.

On the kitchen counter is a set of knives.

The fridge looks new.

>photograph set of knives
*click*
the set of knives is photographed. The camera whirs.

>open camera
Inside the Camera
Your vision is overtaken by dust and film. It smells like phosphor. Your body is weightless. As all good stories, this one has a beginning, a middle, and an end.

An empty picture floats in the space.

You feel as if you can change the world as if you were to change a setting.

>change setting
The world shifts to the middle
 A scene fills the space.  You go to catch a movie, some months after graduation. It was some sloppy action movie, you don't much remember the details of it, but it was a good time.

>z
Time passes.

>z
Time passes.

The scene shifts. You're at work. Frank writes you a text message. You haven't responded in a few days. "I've been busy" you write back. "Sorry". A long time passes, and he replies. "Ok. Hang out next weekend?"

>z
Time passes.

>z
Time passes.

The scene shifts. You're sitting in a bar. Catch-up time. It seems to happen less and less, these days. Him moving away didn't help either. He's busy talking about his latest vacation. He got a very fancy set of knives there, which was probably too expensive, he admits. But the talking is still good, though. You can feel the warmth, even all this time later. What happened to end it like this?

>close camera
Entrance
The Entrance. The shoerack is the same, albeit a bit more dusty than you remember it.

One pair of shoes. Good as new.

A jacket hangs on the coathanger. It's his, you'd recognize it anywhere.

>change setting
You can't see any such thing.

>open camera
Inside the Camera
Your vision is overtaken by dust and film. It smells like phosphor. Your body is weightless. As all good stories, this one has a beginning, a middle, and an end.

An empty picture floats in the space.

You feel as if you can change the world as if you were to change a setting.

>change setting
The world shifts to the end
 A scene fills the space. Frank went on vacation. wants to share the stories with you.

>z
Time passes.

* * *

>e
Kitchen
A kitchen, just big enough for another person to squeeze by when one is cooking. The kitchen counters are clean. 
Back west is the living room.

On the kitchen counter is a set of knives.

The fridge looks new.

>x fridge
You open it. Nothing fresh. No vegetables or moldy cheese. Some sauces, granola bars, things like that.

* * *

>n
Living Room
The most prominent element in the living room his old dining table. Behind it are stacks of shelves. 
The east opens up to the kitchen. Back south is the entrance.

You can see a dining table (on which is a picture) and shelves (in which are an unmailed letter and a project report) here.

>examine shelves
Stacks of books. Opened letters. And one unmailed letter.

In shelves is an unmailed letter.

>look at shelves
Stacks of books. Opened letters. And one unmailed letter.

In shelves is an unmailed letter.

* * *

>p report
*click*
the project report is photographed. The camera whirs.

>open camera
Inside the Camera
Your vision is overtaken by dust and film. It smells like phosphor. Your body is weightless. As all good stories, this one has a beginning, a middle, and an end.

An empty picture floats in the space.

You feel as if you can change a setting, to change the time.

There are memories from each part of your life, the beginning, middle, and end. The setting governs which ones you are seeing at the moment. There are more than 1 memory in each part, though, so stick around (and examine elements of the memories) to see the others.

 A scene fills the space.  A classroom. A teacher. You're sitting in the back, another 50 students or so, spread around the auditorium. It's new and too clean. The blackboard's barely been written on. 
 "You two, you're together", the teacher said. And you were, apparently. You had never met him before, but there you were, suddenly, forced to work together.

* * *

>p jacket
*click*
the jacket is photographed. The camera whirs.

>open camera
Inside the Camera
Your vision is overtaken by dust and film. It smells like phosphor. Your body is weightless. As all good stories, this one has a beginning, a middle, and an end.

An empty picture floats in the space.

You feel as if you can change a setting, to change the time.

The scene shifts. The scene shifts. Before you knew it, you graduated. Together. The ceremony wasn't the fun part, but you did it.  You were damn ragged after staying up all night, fixing commas. But hey, you were alive.

>x picture
It is empty.

>change setting
The world shifts to the middle

>x picture
It is empty.
It is vague, but there are shapes in there. Distant and foggy. A book spine. Glints of sharp objects. And a pen and paper? They are all fading in and out, difficult to tell apart, yet distinct.

* * *

>p shoerak
You can't see any such thing.

>p shoerack
*click*
the shoerack is photographed. The camera whirs.

setting is BEGINNING!

>open camera
Inside the Camera
Your vision is overtaken by dust and film. It smells like phosphor. Your body is weightless. As all good stories, this one has a beginning, a middle, and an end.

An empty picture floats in the space.

You feel as if you can change the world as if you were to change a setting.

 A scene fills the space.  
A classroom. A teacher. You're sitting in the back, another 50 students or so, spread around the auditorium. It's new and too clean. The blackboard's barely been written on. 
 "You two, you're together", the teacher said. And you were, apparently. You had never met him before, but there you were, suddenly, forced to work together. 
setting is BEGINNING!

>z
Time passes.

A classroom. A teacher. You're sitting in the back, another 50 students or so, spread around the auditorium. It's new and too clean. The blackboard's barely been written on. 
 "You two, you're together", the teacher said. And you were, apparently. You had never met him before, but there you were, suddenly, forced to work together. 
setting is BEGINNING!

>z
Time passes.

A classroom. A teacher. You're sitting in the back, another 50 students or so, spread around the auditorium. It's new and too clean. The blackboard's barely been written on. 
 "You two, you're together", the teacher said. And you were, apparently. You had never met him before, but there you were, suddenly, forced to work together. 
setting is BEGINNING!

The scene shifts.

Part One ENDS

* * *

>z
Time passes.

You're in a group room, walls covered in post-it notes. You're both staring at our monitors, working out some problem. As you always did. 
You had your fights, sure. It's hazy, now, to even remember what they were about. You remember throwing a shoe, once. 
setting is BEGINNING!

>z
Time passes.

You're in a group room, walls covered in post-it notes. You're both staring at our monitors, working out some problem. As you always did. 
You had your fights, sure. It's hazy, now, to even remember what they were about. You remember throwing a shoe, once. 
setting is BEGINNING!

>change setting
The world shifts to the middle

* * *

>change setting
The world shifts to the end

>change setting
The world is beginning again
You're in a group room, walls covered in post-it notes. You're both staring at our monitors, working out some problem. As you always did. 
You had your fights, sure. It's hazy, now, to even remember what they were about. You remember throwing a shoe, once. 
setting is BEGINNING!

>z
Time passes.

You're in a group room, walls covered in post-it notes. You're both staring at our monitors, working out some problem. As you always did. 
You had your fights, sure. It's hazy, now, to even remember what they were about. You remember throwing a shoe, once. 
setting is BEGINNING!

* * *

>up
Hallway
A short hallway, just big enough for two doors. One east, one west.

A painting is hanging on the wall.

>e
bedroom
You never went in here much.

A book is on the nightstand.

An unplayed guitar is in the corner.

You can also see a diary (closed) here.

>open diary
It seems to be locked.

>examine diary
You see nothing special about the diary.

* * *

>up
Hallway
A short hallway, just big enough for two doors. One east, one west.

A painting is hanging on the wall.

>w
Guest Room
It's the same guest bed he always had. It was always mildly uncomfortable. But you could never get yourself to tell him. 
Back east is the hallway.

A potted plant is on the windowsill. It's... pretty dead.

>take key
(rummaging your hands through the potted plant, what a thing to do) you find the key in the mouldy earth.

Taken.

* * *

>e
Hallway
A short hallway, just big enough for two doors. One east, one west.

>e
Bedroom
His bedroom. It's very sparse. 
Back west is the hallway.

A book is on the nightstand.

An unplayed guitar is in the corner.

You can also see a diary (closed) here.

>actions
Actions listing on.

>read diary
[examining the diary]
His diary? Did he keep a diary? In any case, it's locked, so there's no way to know without a key.

[examining the diary - succeeded]

* * *

>e
Bedroom
His bedroom. It's very sparse. 
Back west is the hallway.

A book is on the nightstand.

An unplayed guitar is in the corner.

You can also see a diary (closed) here.

>read diary
His diary? Did he keep a diary? In any case, it's locked, so there's no way to know without a key.

>unlock diary
What do you want to unlock the diary with?

* * *

>brass key
You unlock the diary.

>read diary
With slight trepidation, you open the diary. Why are you doing this? You flip through the pages. It's not super well kept. Entries every... third week or so? First entry is a couple years after school. You flip through some more, all the way to the last page. Dated... 2 months ago. 
 Excited about going to Cyprus tomorrow. Gonna be good to get away for a while. 
That's it. That's all it says. Shit.

>e
You can't go that way.

>w
Hallway
A short hallway, just big enough for two doors. One east, one west.

* * *

>down
Entrance
The Entrance. The shoerack is the same, albeit a bit more dusty than you remember it. 
Further north is a living room, and up the stairs is a hallway above.

One pair of shoes on the rack. Good as new.

A jacket hangs on the coathanger. It's his, you'd recognize it anywhere.

>s
You leave the house.

    *** Enough memories for one day. You had hoped to find a concrete answer, but alas, you leave empty-handed 
 Only clue there is "Cyprus", which is vague and unhelpful. Especially two months late. Did something happen there? Was he planning on staying away that long?  
  
You lock the door again and head down the street, camera in hand.  ***

Would you like to RESTART, RESTORE a saved game, QUIT or UNDO the last command?

* * *

>up
Hallway
A short hallway, just big enough for two doors. One east, one west.

A painting is hanging on the wall.

>x painting
It's an art piece you don't know. A woman is sitting on a porch. Huh, not what you'd expect from him.

>p painting
*click*
the painting is photographed. The camera whirs.

>e
Bedroom
His bedroom. It's very sparse. 
Back west is the hallway.

A book is on the nightstand.

An unplayed guitar is in the corner.

You can also see a diary (closed) here.

>w
Hallway
A short hallway, just big enough for two doors. One east, one west.

A painting is hanging on the wall.

>w
Guest Room
It's the same guest bed he always had. It was always mildly uncomfortable. But you could never get yourself to tell him. 
Back east is the hallway.

A potted plant is on the windowsill. It's... pretty dead.

A computer charger is plugged into the wall.

>x charger
Guess he didn't need that, wherever he is. It looks like a new Mac charger too, so you can't use it anyway. Since when did he get a Mac?

>e
Hallway
A short hallway, just big enough for two doors. One east, one west.

A painting is hanging on the wall.

>down
Entrance
The Entrance. The shoerack is the same, albeit a bit more dusty than you remember it. 
Further north is a living room, and up the stairs is a hallway above.

A shoerack. Good as new, and empty.

A jacket hangs on the coathanger. It's his, you'd recognize it anywhere.

>n
Living Room
The most prominent element in the living room his old dining table. Behind it are stacks of shelves. 
The east opens up to the kitchen. Back south is the entrance.

You can see a dining table (on which is a picture) and shelves (in which are an unmailed letter and a project report) here.

* * *

>p shoe
You can't see any such thing.

* * *

>go south
You leave the house.

    *** Enough memories for one day. You had hoped to find a concrete answer. 
 Only clue there is "Cyprus", which is vague and unhelpful. Especially two months late. Did something happen there? Was he planning on staying away that long?  
  
You lock the door again and head down the street, camera in hand.  ***

Would you like to RESTART, RESTORE a saved game, QUIT or UNDO the last command?

>go north?
You can't see any such thing.

>go north
Entrance
The Entrance. The shoerack is the same, albeit a bit more dusty than you remember it. 
Further north is a living room, and up the stairs is a hallway above.

One pair of shoes on the rack. Good as new.

A jacket hangs on the coathanger. It's his, you'd recognize it anywhere.

>go south
exit

* * *

>go south
You leave the house.

    *** Enough memories for one day. You had hoped to find a concrete answer. 
 Only clue there is "Cyprus", which is vague and unhelpful. Especially two months late. Did something happen there? Was he planning on staying away that long?  
  
You lock the door again and head down the street, camera in hand.  ***

Would you like to RESTART, RESTORE a saved game, QUIT or UNDO the last command?

>go noth
You can't see any such thing.

>go north
Entrance
The Entrance. The shoerack is the same, albeit a bit more dusty than you remember it. 
Further north is a living room, and up the stairs is a hallway above.

One pair of shoes on the rack. Good as new.

A jacket hangs on the coathanger. It's his, you'd recognize it anywhere.

* * *

>go south
You leave the house.

    *** Enough memories for one day. You had hoped to find a concrete answer. 
 Only clue there is "Cyprus", which is vague and unhelpful. Especially two months late. Did something happen there? Was he planning on staying away that long?  
  
You lock the door again and head down the street, camera in hand.  ***

Would you like to RESTART, RESTORE a saved game, QUIT or UNDO the last command?

>scenes
Scene 'Entire Game' playing (for 1 mins now)
(Scene monitoring now switched on. Type "scenes off" to switch it off again.)

>z
Time passes.

>n
Entrance
The Entrance. The shoerack is the same, albeit a bit more dusty than you remember it. 
Further north is a living room, and up the stairs is a hallway above.

One pair of shoes on the rack. Good as new.

A jacket hangs on the coathanger. It's his, you'd recognize it anywhere.

>s
exit
Outside the house.

* * *

>s
You leave the house.

    *** Enough memories for one day. You had hoped to find a concrete answer, but alas, you leave empty-handed 
  
  
You lock the door again and head down the street, camera in hand.  ***

Would you like to RESTART, RESTORE a saved game, QUIT or UNDO the last command?

>drop the camer
You can't see any such thing.

>drop the camera
You're not letting go. It feels almost sewn onto your fingers.

>n
Entrance
The Entrance. The shoerack is the same, albeit a bit more dusty than you remember it. 
Further north is a living room, and up the stairs is a hallway above.

One pair of shoes on the rack. Good as new.

A jacket hangs on the coathanger. It's his, you'd recognize it anywhere.

>actions
Actions listing on.

>s
[going south]

exit
Outside the house.

[going south - succeeded]

* * *

>take jacket
You don't want to mess Frank's things. That's what the camera is for.

>open camera
Inside the Camera
Your vision is overtaken by dust and film. It smells like phosphor. Your body is weightless. As all good stories, this one has a beginning, a middle, and an end.

An empty picture floats in the space.

You feel as if you can change a setting, to change the time.

There are memories from each part of your life, the beginning, middle, and end. The setting governs which ones you are seeing at the moment. There are more than 1 memory in each part, though, so stick around (and examine elements of the memories) to see the others.

>take picture
You don't have any hands. How would you do that?

>take setting
You don't have any hands. How would you do that?

* * *

>x camera
You see nothing special about the camera.

>i
You are carrying:
  a camera